11111111111111111111
12222222222222222221
12222222222222222221
12222332222222332221
12222332222222332221
12242242222222222221
12255552222222222221
12255552222222222221
12255555555222222221
12255555555222222221
12222222222222222221
12222222222222222221
12224444444444442221
12224444444444442221
12224444444444442221
12224444444444444441
12224444333344444441
12224444333344444441
12224444444444444441
11111111111111111111
