11111111111111111111
19999999999999999991
19911999191919199911
19911999191919199911
19111199191911119911
19119111191111911111
19999111111999911111
19999999911199999991
19111111111911111111
19199999991199999991
19111191191111111111
19999919191999991111
19191999191919199911
19191999191919199911 
19111199191911119911
19119111191111911111
19999111111999911111
11999999911199919999
19111111111911111111 
11111111111111111111 

Q11-11
