33333333333333333333
30300000000000000003
30300000000030000003
30300000000000000003
30000030000000033003
30000000000300000003
30000333000000000003
30000000000300000033
30000000000000000003
30000000033333000003
30000300000000000003
30000000000000000003
30003000000000033333
30003000000000000003
30003000003000000003
30003000003000000003
30000300003000000003
30000000003000000003
30000000003000000003
33333333333333333333

Q11-11
