33333333333333333333
30300000300000000003
30300000300000000003
30300000300000000003
30000000300000000003
30000000300000000003
30000333000000000003
30000000000000000033
33333300000000000003
30000000033333000003
30000000000000000003
30000000000000000003
30003000000000033333
30003000000000000003
30003000003000000003
30003000003033333303
30003000003000000003
30003000003000000003
30003000003000000003
33333333333333333333

Q11-11
