111111111111111111111
199999999999999999911
199119991919191999111
199119991919191999111
191111991919111199111
191191111911119111111
199991111119999111111
199999999111999999911
191111111119111111111
191999999911999999911
191111911911111111111
199999191919999911111
191919991919191999111
191919991919191999111
191111991919111199111
191191111911119111111
199991111119999111111
119999999111999199991
191111111119111111111
111111111111111111111 