11111111111111111111
10000000000000000001
10000000000000000001
10000000000000000001
10000000000000000001
10000000000000000001
10001111000000000001
10001110000000000001
10000110000000000001
10000010000000000001
10000000000000000001
10000000000000000001
10000000000000000001
10000002000000000001
10000000000000000001
10000000000000000001
10000000000000000001
10000000000000000001
10000000000000000001
11111111111111111111