11111111111111111111
10000000000000000001
11111111111111111111
10000000000000000001
11111111111111111111
10002000000000000001
11111111111111111111
10000000000000000001
11111111111111111111
10000000000030000001
11111111111111111111
10000000000000000001
11111111111111111111
10000000000000000001
11111111111111111111
10000000004000000001
11111111111111111111
10000000000000000001
10000000000000000001
12341234123412341234