11111111111111111111
11111111111111111111
31111333333333333333
31111333333333333333
31111333333223333333
31111333332222333333
31111333332222333333
31111333333223333333
31111333333333333333
31111333333333333333
31111333333333333333
31111333333333333333
31111333333333333333
31111333333333333333
31111333333333333333
11111333333333333444
11111333334444444444
11111444444444444444
34444444444444444444
44444444444444444444